360007894
720859000
001346200
579200086
040768519
816593042
107000465
698000000
000031978