3 6 0 0 0 7 8 9 4
7 2 0 8 5 9 0 0 0
0 0 1 3 4 6 2 0 0
5 7 9 2 0 0 0 8 6
0 4 0 7 6 8 5 1 9
8 1 6 5 9 3 0 4 2
1 0 7 0 0 0 4 6 5
6 9 8 0 0 0 0 0 0
0 0 0 0 3 1 9 7 8