8 0 0 0 0 7 5 9 1
0 4 9 5 2 0 8 7 6
0 5 7 6 9 8 4 0 0
4 9 5 0 7 6 0 3 0
2 0 0 0 4 5 6 1 0
0 0 1 3 8 0 0 5 4
6 0 8 0 5 0 0 4 2
9 7 4 2 6 0 1 0 5
0 0 0 8 0 0 7 6 9