800007591
049520876
057698400
495076030
200045610
001380054
608050042
974260105
000800769