080005060
005049703
360280519
850390007
403700000
000000105
600073951
000020678
798010342