0 8 0 0 0 5 0 6 0
0 0 5 0 4 9 7 0 3
3 6 0 2 8 0 5 1 9
8 5 0 3 9 0 0 0 7
4 0 3 7 0 0 0 0 0
0 0 0 0 0 0 1 0 5
6 0 0 0 7 3 9 5 1
0 0 0 0 2 0 6 7 8
7 9 8 0 1 0 3 4 2