579200168
100057300
840009700
291340080
000001609
600700010
035080906
006070030
000000025