5 7 9 2 0 0 1 6 8
1 0 0 0 5 7 3 0 0
8 4 0 0 0 9 7 0 0
2 9 1 3 4 0 0 8 0
0 0 0 0 0 1 6 0 9
6 0 0 7 0 0 0 1 0
0 3 5 0 8 0 9 0 6
0 0 6 0 7 0 0 3 0
0 0 0 0 0 0 0 2 5