926050080
000400000
005060000
000607000
304000000
200580001
640900208
000000000
009005670