000000079
300800000
080000000
005049000
020000300
000070000
609000040
000200600
700000000