0 5 0 6 1 9 7 2 0
0 0 0 0 0 0 0 6 0
0 9 6 8 0 7 1 3 5
0 0 0 0 6 0 8 1 7
0 0 8 0 9 1 3 5 4
9 3 0 0 0 8 0 4 6
6 0 0 0 0 0 5 0 0
0 0 7 5 0 6 9 8 0