050619720
000000060
096807135
000060817
008091354
930008046
600000500
007506980