4 5 2 0 9 1 6 0 0
0 0 0 0 0 0 0 0 0
0 0 6 4 8 0 0 0 3
0 1 7 0 0 0 9 4 6
2 0 0 6 0 0 7 3 0
0 0 4 7 0 9 8 0 0
6 0 0 9 4 0 3 8 5
9 0 5 0 0 3 1 0 7
7 8 0 0 0 0 4 6 0