452091600
000000000
006480003
017000946
200600730
004709800
600940385
905003107
780000460