600580300
007000000
000402900
405000090
070000160
030000800
020000000
000001040
800029600